crimmeln : aasvogel
bassonm : abalone
vangsteins : abashment
stoughtonk : abayas
nicholsonj : abducentes
dvergstenc : aberdevine
steinera2 : abeyance
yoshidah : abiotrophies
fordr2 : abjoints
schwarzerw : abominators
collinss2 : abscinding
donnellym : abscisins
taskintunak : absinthism
moralesm2 : abstruse
posnerc : abusively
flodine : abusivenesses
mackinj2 : accloyed
uucp : accourage
liangb : accrews
kronickc : accuratenesses
shapiros2 : achondroplasia
berlerm : acquiring
wuj2 : acrobatic
bauschw : acrylonitrile
arbogasti : actinias
washingtono : actinozoan
khana2 : acutenesses
cauthorns : additively
shenm3 : adenoidal
adlert2 : adjourning
kstrode : administrate
clellandk : admired
gibbensa : admired
changt : adversariness
waltersa2 : adversariness
gilbertk : aeneous
avilal : aeroballistics
dregerm : aeromotors
journellm : afflations
konidenap : afflicts
whoopsie : aforethoughts
lekkis : afreet
phelanc : agistments
masaddee : agronomies
ramirezl : airbases
garciar2 : airboats
krantzk : airtightness
mcclintockl : ajowans
vazquezn : aking
careym2 : alchymies
neiroukhm : aldoximes
gardnerj2 : alfaquins
loye : alfilarias
tiltonm : allay
branskyj : allocheirias
oishik : allodium
butlere2 : almucantar
groganr : althorn
salomonl : amberina
wolffm : ambisexuals
olsendufoure : ambulation
randal : amelias
huanga2 : amidogen
steelb : amirs
roizind : amoxycillin
traylor : amperage
finstuens : amphibrach
renem : amphipod
ckohnen : amtman
petersond : amu
fitchs : anadem
sewellk : anatomy
xiongk : anchorman
joness4 : anemograph
buchalh : anemone
cookj3 : angelology
proxy : anglifying
ehresmannp : animadversions
wonacottr : animal
nykampc : anisotropically
neyc : annunciate
wanga3 : anorectics
tannirae : answer
kima3 : antepenult
heuchertk : anteversions
gleasonw : anthologizers
mccayi : antiaircrafts
lentzo : anticks
wangm5 : antilibertarian
finesr : antinucleons
chertoffa : antirusts
ricos : antisepticizes
hadjiyanise : antismokers
jurkovichm : antivitamin
connj : antonymous
vegas : aper
leithere : aplanatically
gnome-initial-setup : apomict
davide : apostille
mellinb : apotheosized
littleg2 : apotropous
gnats : appending
abebayehub : appraisal
hallc2 : approve
blackmonjimenezd : appurtenants
riverar : aquafarming
brodnaxa : arachises
olsonk2 : arachnologist
kannelj : arbelests
daib : arcatures
iftikharw : archaicism
gaoe : archangelic
bin : archgenethliacs
romanovaa : arcologies
ooiw : areal
akindonaf : areolation
thelenl : argentiferous
zhangyangj : arrogant
crowni : arrowing
frym : arrowworms
bloodworthe : arseniate
augustind : arterialisation
jiangz : arterialises
johnsonl3 : arterializes
x2goprint : articulating
vonga : ascend
neumannl : ascendent
wangs7 : ascensions
koellingh : aspartames
fengb : aspects
yimf : asperous
marceln : asphyxiate
frohlichh : aspros
jonese3 : assais
dongh : asset
shugartc : assistantship
cuil : assurgency
hannigank : astonish
sunn2 : astrofell
arafferty : atomizer
liuy2 : atoms
diass : attenders
gerardc2 : attenuates
delgadoj : attractances
mcdermottm : attracting
daot2 : auf
drakedunnc : augmentatives
preissb : aulnagers
walkera3 : aureities
reedc : auriculas
lenniea : auspices
boermas : autobus
boileaus : autographing
gallina3 : autogyro
libergef : autoplasty
valdiviam : avaunted
christensene : avert
cunninghame : aviaries
watsone3 : awarned
leppinkc : ayre
valtierrezf : babblings
keeleyh : bacca
smeyer : bachelor
devgunk : bacillar
grandem : backbond
williamsa : baconer
zhub : badnesses
andersond2 : baetyls
yis : baggit
strikem : bagnio
dushimea : baguet
frankelh : bahuvrihi
pinsonk : balkanised
wintert2 : ballanted
hultmanl : ballasted
guzmanm : ballicatter
princeg2 : bandars
thomasa2 : bankcards
reevesn : bantling
makatsariaa : baps
hozm : barbet
hensonm : barker
debenedettig : barmitsvahs
ramirezj2 : barrat
holcombh : barrios
schroffj : barrow
emmonss : baryta
penprasea : based
gevurtzs : bashings
changa3 : basophile
yagero : batavia
watsone2 : batman
macveaghc : batteled
nystromk : batterie
bryantm2 : baur
siuo : bavins
klinem2 : bayberries
schmidtj3 : beachgoers
silvam2 : beachgoers
orepoorjays : beakier
weie : beardiest
milliganc : bearwoods
fisherk2 : beastily
sschoenb : becowarding
lehmanw : bedspread
millera3 : beelike
nguyenq2 : begetting
sscheirer : beglamour
luapinedac : behavioral
gagnonp : behavioural
tasb : behemoth
jdecker : bellarmines
jussilak : bellpushes
spencere2 : beltways
noisecatz : bemoaners
rubing2 : bemurmured
marinoa : benightednesses
conleya2 : beshamed
farrelle : betaine
smithm7 : betrays
yaps : bevvies
jorlingp : bewrap
goulda : bialy
abarrios : bias
piccirilloj : bikeway
parrm : billfolds
jpierret : biocenologies
petersl : biocide
maxwelli : biodynamic
jamah : biofoulers
moshfeghih : biogenetically
hoffmanj2 : bioinformatics
yipk : biopsies
leeh3 : bioregions
jweisber : bioscience
dambergottm : biotron
goetzs2 : bitchfests
franchotl : biyearly
campl : blacker
preet : blackleg
lewism2 : blankings
johnsont4 : blears
varelaa : blench
nancea : blepharitic
sherrickj : blintze
xiay : blisteriest
blairs2 : blobbier
hamlino : bloodcurdlingly
huffmanj : bloomless
huhe : bloquiste
madsenr : blowziest
goodmand : boardmen
lir3 : bodeguero
gorram : bodyshell
mensendiekh : boldface
rajad : bollix
ouweleenf : bollockses
zacharskim : bonamias
brimn : boogieing
towneb : bookworks
shufrozletzj : boongs
wienerc : bootlicker
lordk : border
lipinskic : botheration
leveyswaine : boused
link2 : bowats
yuane : bowings
mittonfrya : bowpot
tranb : boyish
steinl : boys
barons2 : braindead
edstroms2 : brannigan
raka : brasiers
changa2 : brayer
guerrerov : breadbaskets
wanga4 : bready
masakuraa : breasting
stovallm : bribees
akeelh : brims
heuchertc : bringdown
melvillec : briniest
villagomeze : brogueish
cfortin : bromhidrosis
foxr2 : bromic
powersw : bronchoscopies
uttleyh : broomball
caldero : brose
johnsonk4 : brouzes
maltbye : browless
kernerm : browny
morrisa4 : bruckle
heilbronnerr : bubblegums
leec3 : buboed
myerd : bucksom
dennen : bucolics
ferrerl : bumsuckings
schlicke : bupivacaine
youngk2 : burbot
kuhsm : burghers
ryanb : burnooses
scapicchiod : bush
kimd3 : bushless
kleberd : bushmeat
hirshmane : bushmeats
shirleyj : busting
vidalg : butles
appelbaumj : buzzcuts
ayarsj : bylive
maruyamak : cabernet
tetie : cacodemon
leek2 : caid
jryan : calamity
truebenbachc : calendarisation
aknodell : calotype
hooperk : calumniators
montgomeryr : calyculate
taa : campimetries
fellandm : canceler
moreb : candlesnuffer
gallantj : canisterised
chardy : cankerednesses
mones : cannabis
valem2 : canonically
plackie : canthooks
agboolar : canting
stritzelm : capriole
wolffkinga : caracolled
busht2 : caraculs
smallj : caraganas
johnsonlacosss : carburetors
tpittman : cargoes
gorordoa : caries
knopk : carnal
wangj6 : cartologies
rosenn : cashpoint
farwellg : cassene
luy : catabolised
liz2 : catalogized
greenleea : catechisation
kuangj : catfall
moranh : catfishes
battista : cavetti
aroraa : caviars
stojanovicm : cavillation
goldbergm : ceaze
thengl : cebid
boulism : cenotaphic
leec2 : censored
jaffars : centage
finew : centime
altaweelw : centralizer
mallika : centrode
tongh : centrums
johnsone3 : cerographs
falka : cetyl
conatia : chally
zhangs3 : champing
woollenb : charango
liur7 : charcuteries
rogerss : charmed
eegge : charpies
zhuh : chartography
adachis : checkmark
siddiquia : cheerishness
dawsonr2 : cheesecutters
lia2 : chetnik
roslanskyc : chibouques
raon : chieftainesses
bigorniaj : chiffon
abelsonk : chinawares
jensenm2 : chinbones
hplip : chirognomy
brownt3 : chirring
liw4 : chitosans
taylorc2 : chivvying
ismaile : chokeys
lazob : cholents
sshd : chondroskeleton
batjargalb : chowchows
drakel2 : chromakeys
wangs6 : chronaxie
johnsonb6 : chuddy
qia : chums
hernandezc2 : chunders
thulsont : ciboria
goldbergm2 : cicatricula
mccraryz : cicinnuses
kondas : cicutas
safdarh : circulated
rhyneers : circumcentre
grindej : cissings
tehranin : cite
dierse : civilists
tun : clackdish
christiansene : clamoured
gillardn : classicizes
shabaitah : clasts
nachreinerl : cleanskin
curtisa : clearings
wongc2 : cleche
ahmeds3 : clepes
engermank : clergymen
katarie : clerisy
arnowb : clickless
charltoni : clinkers
coyleh : clitorectomy
bottigerd : clivers
dhaunspe : clockings
burnsider : clubbings
schustero : clubmen
allenm2 : clutch
shaha2 : clutchy
jansenc : coaitas
pic : coassist
slovesb : coccidium
khesinm : coccoidal
sheridans : coches
geoclue : cockbill
taylork2 : cockles
ericksonw : codist
mcmanuss : coenestheses
marlinj : cofeature
carothersl : cognitivities
stahla : cognoscenti
reidt2 : cohibitive
koppelb : colcothar
poolosz : colds
langreen : coleopterous
deweaverb : colleague
calicdand : comarbs
kaumeheiwam : comeliness
camposd : comicalness
rubeyp : comms
rjackson : communitarian
arche : communization
hedgecockn : commutate
muellerl2 : commuted
ramann : companionable
intasinp : complicitous
mendiolam : compresses
bromana : compressibility
mendeza : compulsivities
euaanantp : compurgators
johnsont2 : comstocker
stroebell : concause
mbailey : concertantes
osbornt : concomitancy
jhoelzel : concretenesses
prichards : concretists
jettya : condole
lik : conductiometric
fongj : confirmable
lofquista : conjurators
ramirezt : connumerations
batesh : conquest
kange : conservatising
khayatn : consolating
shahe : consorts
chene2 : conspicuously
westerr : constructivists
tanakas : contemnibly
covingtond : continuatively
boeror : continuous
hembrei : contractions
moroccoe : contriturated
rapoports : conundrums
rybarczykj : converse
liuh : conversely
changstuckiw : convokes
lees7 : convulsionary
zhua3 : copperworm
sandersc2 : copple
pangburnw : copresent
dewyngaerts : corantoes
nassg : cordiality
lchihara : corelate
wangs9 : corniced
smitha5 : cornopean
rykhusm : coronoid
lengx : corporealities
kims3 : correligionists
penna : corroborees
hansone2 : corrosivenesses
seleym : corruptibility
schniedersb : corruptionist
macdonaldj : cosponsoring
choiy2 : cotinga
corboo : cottoning
hairstonk : counter
mccarthys : counterattacked
vilmsj : counterblasts
collinse : counterpoises
lintone : couponings
jiab : couscous
turnerb2 : covertly
kennedyl : cozed
chanj3 : cracker
camarilloc : craniometry
scotte2 : crankles
rosea : craterlets
ruanc : craver
evansg : crazes
cyandell : creamlike
sternh2 : creditors
hom : crenelations
josowitzr : creole
balvuenaa : creston
bassekleg : cretinized
greenj2 : crickets
alappath : cringings
fickl : crispnesses
kunsangt : cross
speech-dispatcher : crossbanded
krakaurd : crossbar
rapaczs : crucian
lowryb : cruelly
butterfieldp : crusado
santamarias : crustacea
sallingerp : crying
morel : cryophytes
johannz : cryptarithm
muraharin : crystalisable
foreros : culinarians
tieut2 : cullion
cheslerb : culminations
fonderj : cuprammoniums
quintanar : curari
rowleyn : curarizing
ngrawe : currier
lefebvres : curtilage
chent4 : curtsies
rigneyk : cuttoes
kohlmanc : cutwork
blockr : cyclopropanes
lachmanm : cycloses
youngbloodl : cylindricality
thurmana : cypreses
bindern : cyprids
stacke : dabbas
gilbertr2 : dacked
louisa : daffodil
chent3 : dahabiah
chaed : daines
caok : dalmatics
nguyent4 : dancettee
lundbergh : danelaws
blairs : daylighted
jamesona : deadbeat
daemon : debauchers
younkinsa : debilitative
wur2 : debiting
martinezs : debridements
mail : decads
idrogox : decarburise
allabens : decentres
donahuel : decerebrated
lowryn : decigramme
forstere : deciliters
viegaseguiaa : decontamination
wattsa2 : decreases
georgeb : deerlike
minj2 : defenseless
yangb2 : defeudalise
berkowitza : defi
riquelmev : defibrillate
marquetteg : defusing
rileyi : degassing
chaul : degrade
sebertf : dehort
kirtnert : dekametre
vaganovv : delighting
dengs2 : demarcated
tuttt : demes
sauera : demoniacism
linl : demonization
hagueg2 : demonologic
neidc : demonologic
lozoyaa : dendriform
nakasakaa : denis
garciac3 : denizened
kammannm : denote
meyera2 : denseness
renz : dentifrice
fraserminesk : dentists
shahs2 : denuclearising
mcclurgm : deobstruents
wonnellr : depauperized
yangb : depends
admadjajaa : deploration
hettlea : depressurises
jamesc3 : derivatise
phillipsw2 : dervish
robertsa2 : desining
fariasa : deviationism
fisherj2 : devotements
kitchenc : dholls
delrosariot : diatonicisms
paka : diazinons
chapmanh : dibblers
perryb : didactylisms
baumgartej : diebs
badjouendzouabea : dietetics
shent : diffracts
reynaldoi : digitules
mcintoshr : digladiations
liur6 : dignity
snarayan : dilapidation
shapirol : dilatant
kellyk2 : dilations
wilcoxt : dimidiate
eislunds : diminishable
kirklandk : dimps
rivesb : dinnerless
crawmerj : diphthongize
powellm2 : diplomat
winhallk : dippy
santamariar : dipterocarp
hollowayl : diriges
liskot : disaffectedness
eglintonh : disapparelling
liebermane : disarmer
swansonm2 : disavower
serranon : disbursals
birdsongs : discipleships
bozicevicht : disciplined
kerwinm : discomycetous
weid : disconcerts
navarrob : discumbers
bensena : disenchanted
rubind : disencumber
kachmand : disenslaving
lehra : disfunction
bradym2 : disfurnishing
savagel2 : disgarrisoning
tierneyf : dishables
glovera : disheartening
morrism3 : disimprisoning
maneenoij : disinvestment
wilkinsonm2 : disorganisation
rojasr : disorganiser
robinsonl : disorganizer
luot : dispeace
garciaa : dispirits
jensone2 : displeasances
kimmellc : displenishments
staffa : disponge
karln : dispurvey
statd : disseised
oettingerj : disseize
krala : dissolutive
horwitzb : distichous
kellyw3 : distrixes
duanc : disulphates
robertsr2 : disunionist
bregouc : ditas
cohena3 : ditch
sunk : ditchwaters
kimberks : dithering
angevinej : diuretics
peoplese : divaricately
tordib : dizzard
lichto : dobsons
backup : doctorands
gaughanc : doctrinarians
prenticea : doggo
lemastere : dogsledded
avahi-autoipd : dolphinfishes
liuy3 : domatium
karpe : domineering
solomonf : domineeringness
vozzar : dongolas
norwoodl : dons
mvanderw : doodler
bowlanda : doomwatcher
serotam : dorhawk
holta : dorring
assafn : double
webbn : dovecot
ristinoa : downfield
tarasd : downlight
satherz : downloading
rfjones : downmost
klinesharpec : downplay
szafrano : draffish
dehaans : draftinesses
tananbauma : dragonfly
dwalser : draughtboards
durnbaughe : drinkables
soufanm : drooliest
boehnkeb : dropstone
sauerbergn : drouking
schultzc2 : drowsy
brindleg : dryable
hiranok : drying
mcconnellm : duchessed
dema : dunging
smithj6 : dunt
shaoe : durns
alia : dustlike
mccoyc2 : dynamos
isaacsa : dynasties
pelletierz : dyscalculias
lib2 : dyvour
stubbsa : eaglestones
blairsmitha : earlship
coffing : earmarking
dhugumak : eastling
frostb : ecclesiasticism
luljakj : ecclesiologist
daviso : echopraxias
kuh : ecoterrorism
ironsw : ecoterrorisms
parrotth : ecstasizes
fairk : ectoprocts
mazura : edaciousness
dorchens : edutainments
cburden : eerinesses
qins : effendis
messagebus : effortful
busche : effusiometer
lewisd2 : eiking
isaacsonj : eilding
loesper : ekpweles
nelsonb2 : electronicas
engela2 : electrothermy
gjertsonm : electrotyped
fernandesj : elegiac
hiltym : elopes
rosenbergh : elytriform
hopek : embayld
nit : emblazonries
ringrosec : emblics
lasterk : embraces
jbushey : embusies
katariay : eminency
mungerk : emotionalism
jacksona3 : empts
quattruccii : emules
blacka2 : enables
dhungels : encapsulates
pasleyo : encash
wnorth : encore
saida : encrypt
nelsong2 : encyst
vanders : endangered
mcwilliamsc : enderon
hannak : endoplastic
harmonb : endoscope
sethl : enfire
vazquezi : engaging
wyffelsm : engoring
smohring : engrainers
dimondc : engraining
tinajeroa : engrossedly
ericksonk : enhypostatized
mrood : enkindle
frankela : enmities
hauserj : enterchaunge
williamsj3 : entrances
sagalg : entreating
tumaa : enveigle
mothersheads : environment
chuc : environs
swarups : enwombing
rosez : eocene
zhanga3 : ephorates
wrighta2 : epignathous
schwartzb : epilogistic
friedmant : epiloguing
benoya : epoxidize
knezevicm : equibalanced
rojanasoonthont : equinely
tilleyr : equivalve
befekaduh : erasures
keithahnh2 : ericoid
smithm6 : ering
abbasharm : erlang
choij : erotical
kendallb : erotology
rweiner : erraticisms
iyera : eryngo
brownp2 : erythematous
asfawa : erythron
yorkd : escalatory
hudsons2 : escalopes
x2gouser : eschatologist
wolft : escorting
mccartys : escrol
hanchetg : escrows
weges : espanoles
kemptond : estruses
boroughsc : etapes
johnsone2 : etas
liesmanj : ethnarchy
andersoni2 : eths
matthesg : ethylbenzene
hintons : ethyls
tardio : etiquette
smitho : etrangere
kampa : eucaryons
loxe : eudemonist
mayoralg : eukaryons
hallc3 : eulachans
zengd : eunuchizing
coganp2 : eunuchoid
bettnerb : euryhaline
guw : eutectic
pseneviratne : euthyroids
oddene : evos
magerl : excellent
bradies : excrement
mertzn2 : exhalant
sochackim : exheredated
bodanskys : expatiates
leslieg : expires
chenge : explainable
culverwellr : explicit
rtkit : explosive
cokera : expressly
mcdonnellp : externally
abougabals : extincted
mendozav : extralegal
minoe : exuls
mitchelle : eyalet
brusilows : faddy
fosterk2 : faeries
cohena2 : faintness
hollebp : faithlessly
halla2 : falchion
jahne : falsifying
amagaik : falters
ashe : fanaticizing
davilav : fancifulnesses
dominguezb : fastigium
alejandroe : fatless
mcgeheej : faugh
farrl : fauna
passinok : faustian
emmonsm : favouredness
thornea : fehme
paulsoni2 : fehmic
rapaczs2 : feliciter
paaschek : fellation
hawkesk : feminineness
ccollins3 : femmiest
scottm3 : ferbam
fraziera : fertilest
nossw : ferula
kirkhoper : ferventest
hershewee : feudary
tourea : feudatory
brandlc : fiberizing
bailardj : fibromyalgia
lewisj2 : fictitiousness
caoy2 : fiddlier
kimbels : fierier
finneye : filmcards
kombatem : filtering
kchapman : fineers
liny2 : finickings
pakl : fissioning
cfarhart : fivepin
buhmans : fixatives
tut : flabs
newmanl : flaccidnesses
qine : flaffed
shafers : flaggy
melomejiac : flagitation
lowere : flannens
sjandro : flannens
buonopanee : flapdoodles
konshiel : flauta
sottrelh : flavorings
frischm : flehmened
sirulnikb : fleshiness
phamm : fleshworm
rosethc : flexible
ahrensd : flick
weedens : flimp
deharpporteh : floorheads
hansong2 : floribundas
breyerr : flub
lburdell : fluidities
polydorouc : fluoxetine
kimballk2 : flyless
cunninghamf : flypasts
viswanathana : flypitcher
hansonc2 : fogydom
chena5 : foisted
klanderudj : follicle
mcnameec : foreboder
dunnr : foredoes
gautiere : forefeeling
arzayusl : forereaches
chhuganis : forerunning
lanzilloj : foretime
felknork2 : forfended
loea : forhooied
trank3 : forkers
pulse : formably
blanchardm : formalise
capeilleresh : formalizable
hawkinsn2 : formfitting
patinon : fortepianists
gormallyc : fortunes
roya : fossa
sullivank : frangibilities
parsonsa2 : freedwomen
webbj2 : freety
smithj5 : freewheel
freemanc2 : friedcakes
hummeln : frigate
shapiroj2 : frilling
daleyj : froes
klosa : frostbitings
rahmans : frowsier
hicker : fubsiest
plaschl : fuchsine
tillinghastn : fugging
halladaya : funder
herberss : funkhole
gaborm : funniness
ihlenfes : furfur
hawadlea : furfuran
pickense : furol
johnsonb5 : furriner
syoon : fustilirians
onomiyan : gabbroitic
woleskyp : gabelle
yuana : gadget
rubinpopea : gainlier
williamse2 : galenical
cardenasl : galenites
hoppera : gallanting
emekar : gallantly
ismaily : gallnut
franklp : gallonage
painem2 : gamelans
alvarezm3 : gammadion
nairs : gammatia
eldridgec : gampish
lasleyc : garbologists
terwilligers : garcinias
thillm : gardening
chunge : gardenless
moorek2 : gasp
richierip : gastraea
msehgal : gastronomical
coynej : gaumless
papajohna : gauped
aokib : gavials
orensteint : gawkers
jenseng : gay
dyermokg : gaydar
johnsonp4 : gazements
mihiram : gelate
borgmanns : gelatinoids
bistrupi : gemman
mkaga : genotype
yus2 : geognostical
kellyw2 : germain
zhangs : geropigas
cookes2 : gests
diallod : ghazis
munn : ghostwrites
steinl2 : giantship
tashjiana : gied
duffyk : gilded
bronstonea : gildhall
jacobso : gimmals
gracej2 : gism
crossh : gladwraps
dominguezj : glamourpuss
donnellyp : glands
nguyenc : glassmaker
nlutsky : gliffs
lorda : glisk
torstensonl : glockenspiel
amoulana : glorify
hawsj : glow
hansonj3 : gluepots
whitec2 : glueynesses
normana : glyptal
wataokac : gobioid
keiltyf : goblet
diazg : godslot
westj : goldfishes
vadnaiss : gonfaloniers
liur5 : gonorrhea
gebreegziabhery : goodwilled
ramirezs : googolplex
kroppa : gopaks
obiesel : gophering
gibsonm2 : gophers
spezian : gorges
nguyens3 : gormandiser
roskopfe : gouging
abdih2 : gradatim
uyedah : grailes
ramosj : graithed
liue2 : gramary
pikej : gramophonist
trawalleym : grampas
watowichm : grandiloquently
pandelakisn : grandsire
schifferc : graplements
vanderc : gratillity
mehtat : greaten
babcockc : greeted
morrisa3 : greeting
qil : grevilleas
nakahiraa : grillrooms
ishikawas : grittest
pfeldman : grizzle
baxn : grooveless
caser : grouped
wange3 : gruffly
slaytonc : guacamole
padillac3 : guidon
orozcoa : gummata
weismannh : gummosity
eidmannt : gumshoes
stemd : gurjun
rohdem2 : gurus
palenovad : gustie
schubertr : gutterbloods
schafers : gutturalism
jhallen : gynies
blagburnd : gyny
ingrame : gyrofrequencies
escutiam : gyrovagues
ramazania : habitat
thurowm : haemostasias
xaviert : haes
claphamc : haftaroth
steinbergk : haftorot
beckerr3 : hagiographic
dencklaz : hahas
darwishs : hailiest
ochoaj : halal
anyiwee : halfway
zhuy : hallucinogenic
caldwellm : hammertoe
wahlj2 : hamshackled
heinzelj : handicrafts
whitfielda : handlangers
kleinhansc : handplays
jenksg : hangmen
koroseie : hanks
vancea : hansardise
brinkj : haplonts
guox : harbourless
lopezn : harmonist
khana3 : harpers
maitlandl : haurient
cowane : haves
pearsong2 : heard
chenj3 : hearthstones
williamsj4 : heatednesses
endoi : hebetative
dmusicant : hectographed
flinnc : hellenised
quinterod : hemicellulose
yuk2 : heptathlons
phamd : herbologies
spatters : heteronymous
tamert : heteroploids
walutesj : hexachlorethane
honga2 : hierogrammates
williamsc3 : highchair
morduchl : hilloed
wernerg : hindshank
pareth : hippophagists
leee2 : hispidity
woodruffn : historiology
dappleya : hoars
brookmang : hobnobbed
freedmane : hokku
leeb4 : holk
tisserandm : hollowares
reynagag : holophytism
satisha : holyday
myerss2 : homaged
ahmedt : homemade
sivulat : homeport
grossmanj2 : homesteaded
dalberg : homogenies
wengs : homotaxial
newmant2 : honourless
parkj4 : hoochies
icklerj : hoodwink
aguirree : hookworms
oldhamm2 : hookworms
mctaggartc : hospitia
helmboldk : hudnas
rafkina : hules
khake : humoralist
saintils : hungriness
hliuspen : hybristic
yaxn : hydration
brownc3 : hydrocelluloses
shanson : hydrochores
colord : hygrodeik
kitamuraa : hylozoisms
mitchellm : hyoidal
mohamedh2 : hyperalgesia
broadbentc : hyperexcitable
quaylep : hyperidrosis
stateno : hypermanic
schaefern : hypernym
speranzellaj : hyperpnea
wus3 : hyperpure
rankini : hypersensual
pihlajaa : hyphening
venetise : hypochondrium
lellison : hypocorism
gatesj : hypocrisies
maw : hypoplastra
smithk4 : hypothesis
osham : hypsophyll
byund : ignite
battlew : illegible
ogutum : illiberality
groosj : illusion
vosena : imbroglio
glaubitzs : immarginate
kimzeyo : immoralisms
bombeik : immovableness
przybylan : immurements
deferm : impala
bergk2 : imparled
quasts : impendent
howardm2 : impersonalised
keena : impingements
arovasa : implacableness
phungk : implants
ramekeri : implodents
hurtubisel : impresari
sakimoto : imprimatur
laveys : impropriate
tamj : improvidences
fortsone : inalterably
dnsmasq : inamorato
mohameds : incentivise
zhoutan : inching
danielsonk : incliner
reyese : incloser
johnsons2 : including
borgmannm : incompletions
wiggint : indicative
johnsonj4 : inessives
rewc : inexistent
ricos2 : inexpugnably
mitchellk : inflammables
biddulphe : inharmony
gregoryj : inhumes
qux : innovationist
barhama : inseparableness
tanakar : instaurators
yanga2 : insufficiencies
sys : insuperableness
flowersr : interbehaviors
wolfflandauh : interchannel
flanagano : interclub
hughest2 : interdines
brooksa3 : interestingness
clinecolee : interinvolving
shibuik : interjector
topels : interlaminates
aestill : interpermeate
zhaiw : interplaying
newmanl2 : interrogational
betzg : interruptors
chaffeeb : interserted
rasmussenm : intersperse
moores3 : interwove
sheltoni : intestacies
youngrenk : intimidatory
garciad2 : intranets
geistm : intraocular
choir : intreat
alsakerj : intrencher
pageb2 : intriguante
griers : intuitionist
hrubya : inulase
hirshmana : invades
hosem : invaginates
jbrioso : invalidator
whitej3 : invariables
stadelmane : invariancies
ballingerl : inventory
hikens : involucrum
somaa : invulnerably
wilderr : irascible
alvarezj : irksomenesses
floresg : irones
zhue : ironmongers
tessieri : irradiator
sync : irrecognizable
bettinm : irrepleviable
lankfordr : irresolvability
shenholma : ismatical
eatono : isogons
man : isographs
onwumerea : isosporous
costelloc : itch
buhmanq : ixtle
beimersa : izar
legbaf : jackal
zhangj9 : jaculated
salazarv : jarl
strathmana : jatakas
kingmal : javelining
lanegraffe : jettisoning
mhansell : jibbs
cannelli : jobless
dmarshall : jointednesses
lesurea2 : journalistic
meiklec : juke
bartkovichj : juncuses
kyrysyuks : juridical
kindallv : justle
yeracarist : justly
ganjams : juxtaposes
paulyg : juxtapositional
subramaniana2 : kabaddi
partidaa : kaifs
ricea2 : kakapo
whited : kalends
bouzaa : kamikazes
horiuchih : kapellmeisters
marquisz : karakas
bushmanc : karstic
pinac : katti
claybakers : kazatzkas
scoolerh : keelhauling
laubo : kell
bakkej : keystoning
claussm : khansamahs
reedwestonm : kiddywinks
makia2 : kikuyus
szetob : killies
beckerr2 : kindreds
songy2 : kinematography
browni : kirpan
williamsn : kithe
kalmusm : knotweed
lima2 : knout
sachse : knowings
manivelm : kobang
grieselb : koeksister
cfureslo : kojis
gerbinoa : kolacky
mosesh : kolo
caie : kouros
dauriac : krauts
pengg : kyaks
awb : kyangs
luongh : labiality
bowersj2 : labialize
rekemy : laborites
mcmillanr : lace
songc2 : laced
biny : lacerability
zuczekx : lackering
rdobrow : lactalbumins
keelp2 : laggens
williamsc4 : lairing
delgadoa : lamedh
luoj2 : lamellation
wegea : laminous
olandert : landsman
mathcsadmin : lanker
rileyo : lapin
sawyerm2 : lapstreaks
gaoa : lardalites
knappc : larruped
misplonj : laryngoscopy
huynht : lateralling
owensj2 : laterals
dacunham : latinized
pinaa : latrocinies
tieut : lattens
caplowh : launchpads
news : laundry
leduce : laverocked
tlittle : lazies
shresthaw : lazzo
caradimitropouloj : lead
awadm : leaderless
atont : lecithinases
pozzii : ledger
sivulaa : leges
maymudess : legionaries
sasserd : legionellae
malik : legumin
rourkee : lehrs
stametsm : lemniscal
tangumaj : leno
dujsikovaa : lentigines
kaitanym : lepidolites
dennehys : leproseries
cochranl : leres
seymourc : leukocytic
bordenm2 : leveller
buyuccanm : lexicography
tellea : li
huangv2 : libriform
onyeanuj : licensers
basavareddir : licentious
murphyh2 : lichenologists
deleonc : licitnesses
uchitelj : lickerishnesses
odoome : liefs
townsendl : lieutenants
naj : lieve
ellefsone : lifes
beddoww : lilliput
hamiltons : limeades
kumars : limmers
wetzelr : linguistic
jolson : linkage
murphya2 : lioncel
blanchfieldp : lionfish
richardsonb : liquored
mccarronl : listerial
hintonp : lithifying
blackette : lithoid
fredericksa : lithomarge
hagarm : loach
zhangd3 : lobber
zhangh : locksmithing
xiongk2 : logarithm
cardozaj : logion
morrisseya : lolly
leonarda2 : lonicera
gassele : loper
hommeyerj : loutishness
herreraf : loveliest
songj2 : lowlighted
mateosk : lownd
tune2 : lukewarmish
bkopack : lukewarmths
guzmanc : luminescent
jbryce : luncheonettes
bailona : lusterless
guoa : luthier
rankinm : lycee
thomleye : lycopenes
tennentr : lysogenizes
olsone2 : macaws
petrinih : machzors
omoiyamuo : madzoons
antrimr : magnesic
humese : majlises
samselt : malaria
drummondj : malevolences
johnsonm3 : maligner
jstrand : malingered
whitej2 : malmags
akiyamaa : malonate
dicarlos : malteds
parkersone : mammifers
walshw : mane
krollc : mangelwurzel
smithm5 : manifestations
mkruseme : map
marquezd : mararis
gunnarssonm : mares
bassp2 : marketizations
mccreap2 : marlinspike
boylee2 : mastoid
anyaegbunamu : matroyshkas
ahlgrenk2 : mayday
mjflynn : mayster
okadak2 : mealing
lina : means
panm : mediaevalist
yamadad : mediateness
friedmanl2 : medicinal
reinhardtc : megadeals
shteymanm : megatonnages
baggetts : melicotton
jordanl2 : melismatic
vipparlaa : memes
maringc : menses
cichowskil : mentorings
chans : merchandize
hoj2 : mereological
hofmannm : meridians
goldenberga : meridionally
obergj : mesaticephalies
mikulskit : mesquits
marvinc2 : metamorphism
nakamotos : metaplastic
barryhan : metasoma
alvarezruizc : metaxylem
hmiller : metrical
munyeshyakam : metrics
chesivoire : metronomically
nechiporukm : michings
yeomj : microcephalous
crewsa2 : microchip
glaserz : microgram
fitzhughn : micrograms
muellern : micrography
schafern : microloan
caiw : micrometeoroids
thomask2 : micropolis
websterc : microtone
hallmany : midges
djerfp : midinette
kiernanl : midships
caglieroe : midspace
miless : migraineurs
yeec : mikvos
reidn : milliners
whiteg : mimmicked
goldmanc : mindedness
barbere : minds
eiferta : minidish
baigt : miniments
isbelln : miraculous
lanierd : misalleging
dellefaves : misallotment
cardenasa : misate
perfettos : misbutton
kingn2 : miscarriages
johnsonl2 : miscomputation
frieds : misdeemed
johnsona5 : misdiagnosis
moranl2 : misdirection
kharea : miseases
barzele : misfaring
romanenkos : misgoverns
uyekif : misgrows
zhenga4 : misimpressions
gelosf : misliving
rodriguezd : misnaming
dass : misprizing
hartzella : misseem
lees3 : missent
orlinz : misspeaks
thandis2 : mistermed
floquetl : mistitling
chend2 : misword
nelsons2 : mitosis
sheny2 : mixers
owensm : modalist
tranr : modalistic
alexandera : moderatrixes
ezemosakwea : modii
banovetzm : molecast
bells3 : molehill
its : molybdenous
cordovai : mondains
chenk : monochlamydeous
saksenac : monochromists
luongn2 : monocycles
rosenfeldk : monogamic
rojeke : monogeneses
jamy : monohydrated
zhangt : monoplegic
aronsonj2 : monosymmetry
harrisl2 : monovalences
jondich : moose
chud : morbid
hempels : morphinisms
songy : mosbolletjie
ntp : moschatel
nachtm2 : moten
christopho : motorbicycles
gormana : mouching
phelpsr2 : mouldwarps
geletar : movieolas
krajcc : mucronation
shreerom : muddleheadedly
diiuliol : mudirias
heine : mudrocks
adamsc2 : muensters
thomastothe : multibladed
windleyb : multiflash
diamondl : multilingualism
zhangc3 : multiloculate
leblanct : multimember
ehrhardtk : multipartite
navarroj : multiservice
smithc5 : mumps
renb : mushiest
cuttera : musketoon
mahmoods : mutinying
mayfieldc : myasthenias
gonzaleza : mycetologies
houcko : myomas
banfieldb : myriapodan
lil3 : myrioscope
rbarkmei : myxamoeba
lynchb : myxoedema
leed3 : nach
sutcliffea2 : naifer
banuelosg : naivest
wangz : nannygai
demetriadesl : naphthylamines
nguyend : narrows
thompsonw : nas
imaik : nasality
vostinar : nasopharyngeal
jcernaba : naturae
ohrstroma : naturalizations
whartonl : navar
hansonn2 : necessaries
omarac : necrophobia
parsonsk2 : needcessity
hogansona : negotiabilities
winicks : neoteinias
dpearsal : neoterised
cochrane : nepheline
givensn : nephroblastoma
zhangf : nephroscopies
smallj2 : netops
greengos : netted
harrisn4 : neural
lkolek : newborns
dorchenk : newed
fraleyj : newsagents
buffettz : nidificated
alveys : nieces
cheryb : night
mckinleys : nightjar
rasts : nightmare
flignorj : nincums
ortegaj : nineteenthly
margolisj : ninons
rittmanh : nipper
fridkina : niteries
hansonj2 : nithered
zouy : nithering
chenc4 : nittier
chens5 : noctambulisms
washingtonj : noll
chingl : nominal
miyagik : nomologically
stecklowm : nonadiabatic
chatardl : nonconductor
lie2 : nondeforming
rhodess2 : nonemergencies
storke : nonevent
naganumaj : nonfictional
lees4 : nonfinite
dbastola : nonguilt
gnelson : nonguilts
varmaa : nonleguminous
snowbecke : nonmobile
petropoulosa : nonobservant
readyp : nonoxidizing
linj4 : nonpagans
contrerasb : nonparity
belli : nonresistance
floress : nonruling
nguyenj3 : nonsequential
lp : nonstaples
majumdarm : nonwhites
waltherp : nonwoven
andersonb : normalise
russellb2 : northings
jamesc2 : nosebleedings
glosss : nother
stieglerr : novenaries
sullivanr : nozzers
tchouaffem : nuance
yanj : nucleosomes
drapers2 : nuffins
kessenichs : nukes
soehnlinn : numeration
wrighte2 : obeisms
tianh : obese
bellonie : objurations
yoony : obligers
kastnera : observationally
bierleya : obsigned
moyerj2 : obstructiveness
sanghia : obtainable
cups-pk-helper : oceanfronts
ogilviej : octadic
games : octogenarian
chasnovm : odiously
zhanga2 : odontolite
westone : odours
wangc4 : oedometer
overbyj : officialdom
galambosd : oftennesses
nobody : oligochaete
mamantove : oligodendrocyte
jinga : oliphants
nootenboomk : olycook
aswoboda : oncogene
mlupp : oneness
ballen : onomatopoeses
onabolub : ontogenetically
shalitak : oophorectomise
liq2 : opacifier
goldberge : openmouthedly
kellyc2 : operatics
lwinh : ophiolite
zhangs4 : orarians
farmerk2 : oratress
hutchinsonm : orcas
tankersleyc : originated
sainiv : orthohydrogens
chana2 : oscillative
hazeng : oses
stolberga : osteal
laij : osteodermous
uuidd : ostraceous
loewa : ostreophages
liangj2 : oughlying
olsonc3 : outbacks
kleinh2 : outboxing
fjaramil : outbreed
eae : outdistanced
ferrere : outfalls
jabbarpourc : outflashed
henryi : outgained
wangy3 : outgalloped
sbeckwit : outlives
lanierk : outmeasures
arnoldp : outmuscles
dubinskye : outparts
starlackr : outpopulating
akyianua : outsmiling
cartwrightb : outspokenness
bartont : outsweeten
greenm3 : outthieve
apchikka : outthought
farnsworthh : outvillained
kroegers : outwith
mallyas : outwriting
goldenbergz : ovary
awady : overattentions
gravesm : overbearingness
hev : overbig
chungd : overbrows
palmbacha : overcrowing
swansonl2 : overcultivation
reisenfelda : overestimating
smiths2 : overexerts
rockd : overfamiliarity
mere : overflourishes
zemanj : overglamorise
tinea : overinvestment
kojimam : overpackages
berryn : overpraise
santosb : overseeing
masakin : overselling
fanp : oversubtle
fostert2 : overthinks
qina : overwatered
uribec : oviductal
macarthurn : ovulate
maierj : oxacillins
delnegron : oxgangs
sainzn : oxidizing
sleonhar : oxtongue
qureshik : oxyacetylenes
morscheckc : oxycephaly
stepanskiw : oysterers
andrewsa : ozonize
beretsl : pacemaking
riersond : pacificated
bastimarr : pacificating
boydr2 : packhorse
walkerb2 : packsaddle
mcass : padauk
bushj : paddy
burtonk : padrones
donohoc : pagehoods
selkowitzj : palaeographists
meyerb : palaeography
mkanazaw : palatalisation
danksm : palilalia
kellyr2 : pallets
chappellg : palmatipartite
leeg3 : palolos
prinsm : paludamenta
lederere : paneer
moonblackj : panegyrica
gallegoj : panophobias
pattersonc : panpsychist
relveton : panzers
jingg : paradisean
rkeiser : paradoses
nevillek : paramagnetism
bestb : paraphiliacs
brookskahnh : paraphrastic
fabera : parapineal
hoffmanp2 : parboiling
ehrhardta : parchmentizing
haileabd : pareses
zhangx3 : parklike
rothmana : parras
destah : particleboard
smitherbm : particleboard
hawkinsm : partings
greenleee : parures
brodyc : parvenues
choderat : passades
bergerj2 : passatas
mcgregorr : passemented
zhangm3 : passionately
eidelhochm : pasture
becklerj : patellectomy
schillj : patriclinic
johnsond2 : patrols
charlies : pazazz
carreteroc : peachily
whitet2 : peacoats
warners2 : peckier
greenoj : pectens
bachulisj : pedder
thantm : peising
luedkeh : pejorating
woodruffe : pekes
mrand : pelage
liphartc : pelmanisms
zhangw : pentacrinoids
xiongl : penumbra
sassl : pepsin
kosekm2 : peptids
jellinge : perambulator
munkr : periboli
longe : perichaetium
fieldl2 : periostitises
storliee : perissodactyl
yangw2 : peroxidizing
johnsona6 : peroxy
martensj : perpetuated
jcwillis : perseveringly
kirala : persicos
belzert : persistences
bessore : persona
elliottc2 : pethidine
davanzoe : pettifoggery
johnsonc3 : petunias
merrells : peytrals
hashimotok : phagocytises
fernandezm : phalangids
boydl3 : phantasime
lefeversb : pheneticists
tmyint : phenylenes
machaleck : philologue
cabanelak : philomela
floydt : phlebotomist
carlsone2 : phlegms
rittera : phonate
jewelerb : phonation
gudgelr : phonemicises
ulicnys : phoney
turnerk : phonographies
shahidm : phosphatise
tomlinsonk : phosphine
hoenem : phospholipases
sternsc : photogram
szafranj : photoinduced
quadea : photojournalist
bruelle : photometers
clarkb3 : photomontages
srinivasans : photorealisms
merchantc : photoreception
maags : phrasemongering
knutsene : phratries
tyreek : phratries
busisd : phrenesis
profittl : physically
tsuic : pi
lik3 : pick
haddockc : pictogram
jtymoczk : piednesses
hanshawf : piemen
hagstromp : pigeonhole
clawsoni : pilferages
baldoj : pilgrimising
michiia : pilot
yumk : pinealectomies
purduma : pinies
metzf : pinkeyes
benklern : pinpoint
ursina : pintle
cappb : pipetting
shanaas : pipings
liuj3 : pipsqueaks
markerm : piquance
polancoa : piquing
clayo : pistolet
bobob : pitcherfuls
shannoh : placate
scheiderd : planched
buckk : planchets
mccartneyr : plasmasol
posh2 : platier
chaob : platinocyanic
drennana : pleasuring
batsaikhanb : plebbier
polleym : pleiotropic
nahleyc : plenishers
becerraa : plentiful
boskovica : plethysmogram
puzellaw : pleuchs
schuelkek : pleuritises
agarver : plimsoles
garciam3 : plumbous
baeckn : plumpish
timminse : plunderable
pollardc : pochards
amoltcha : poem
beyenee : policed
donovanm : politicasters
luoy2 : pollucites
friedena : pollutednesses
widmana : polo
kangt : polonies
dongz : polyhydric
kernoops : polyonymous
goldhaberz : polyphones
rhea : polypidoms
dgroll : pompier
irwinp : poppets
schregardusc : popsies
paltrowe : porogamy
olsenf : porting
wiegmane : portion
chenr6 : posits
donahuea2 : posoles
neithartb : postforms
irc : postulancies
glennb2 : potbound
yamadaj : pothecary
carteri2 : poundcakes
wittej : powin
asifs : pranckes
tomj : prao
davisonm : prawns
linki : pre
linb : preadapts
ngot : preappoints
jonesb2 : preassure
richardsc : precancerous
aloy : precedential
jonest3 : precedents
coletm : precensor
odak : precludes
clarka2 : precognitions
detmerh : precompetitive
sharmas : predestination
roym2 : prehended
baskaufj : prelateship
tefub : premoved
zeilingera : prenatal
reeshille : prenatals
iyengunmwenae : prenubile
tmadsen : preppiness
raiu : preprogramming
brennano : prepuces
barnetto : prerock
teetert : presentnesses
minj : presidentess
choud2 : presidentships
steinr2 : presterilizing
schulenberge : presternums
reinholde : previable
shucka : prewarming
bigelowa : prewiring
hinrichsr : prewriting
bacong : pricelessly
ashurstd : primines
alexanderj : prisers
macleodh : pristanes
bartelsj : prizefighting
mullanj2 : processes
edmondsh : proctored
strandn : proctorise
yangm3 : projectment
riessb : prokaryotes
huad : prokes
jurotichm : prolepses
chill : promissorily
hoytniemieci : promoted
woodsj2 : prones
mckelveyb : propagandistic
mayerm2 : propaging
list : propinquity
dippoldc : prostantheras
lelea2 : prostomial
popem : protestors
tietyeng : prothonotariats
huntm2 : protractedness
garbym : provokers
kenneyj : psilomelane
phinneya : pteridologist
sherrickb : publishable
danielskoche : puddening
feldermanj : puggings
jdavis : pullbacks
northj : pullup
keanel : punchboards
docterloebj : punctos
knights3 : punditries
sarnos : punners
leisherz : punny
sayanic : punto
williamsn2 : pupation
leakek : puppydom
gohelc : purgatively
nagpalj : purtraid
hhuergo : pyelitis
yime2 : pyramidology
walshm3 : pyritical
weil : pyritical
kayem : pyritiferous
rnau : pyrogenic
velasquezc : pyrogenicity
brownlawa : pyrolusite
navratilj : pyrometer
shim : pyrotechnically
helgerude : quannets
jinleeh : quarterlights
wyckoffs : quartetto
bahnm2 : queasiness
gershmanw : queenships
foxarnoldd : quelea
cortesv : quicksteps
smarta : quiddle
caseyf : quiltings
moralesc : quindecennials
bensenh : quits
grossere : quivering
wrigleye : quizzifying
huh : quotients
gordong : rabannas
westawkerl : raca
lonea : racehorse
zhangc : rachiotomies
rolandc : radicalized
gdm : radicule
zweifelc : radiesthetic
sinhaa2 : radiopagers
alexanderd2 : railman
sparksp2 : ramming
root : randomises
jonesz2 : rankers
kaplang : rantings
xues : rareness
bansea : ratan
thurstond : ratcheted
davidsons : rationalist
kartheisere : rationalistic
baxtera : rattener
tianz : ratton
laytonm2 : reaedifyed
rubinot : reapparels
salijk : reappraisers
hanw : rearisen
wenc : reasonabilities
joness5 : reasonably
moyb : reassailing
rosenfeldm : reawaking
dasilvab : recarrying
liaog : recceing
shapirob2 : rechoreographed
syslog : reciprocate
lutherj : reciprocator
bicej : recladded
sullivanl : reclaimed
wuj5 : recodification
bascomi : recommended
riveraf : recompressing
connelln : reconstructed
willsr : recreated
kadams : recriminations
klineb2 : recross
hahnj2 : recurrence
kischnera : recycle
gangulya : redaction
allenj2 : redargue
rosenc : rede
bruihlera : redefining
fioccoj : redemptional
pengd : redeployment
smithr4 : redetermining
diazgarciaj : reduce
richterb : reestiest
wuy3 : reexpel
arbogaste : reexportation
herrc : references
jschicker : referrible
rodriguezn : refine
puzakm : refitted
gwina : refixes
suhd : reflectorized
washburna : refluence
toledod : refocusses
meia2 : refreezes
huangc2 : rehospitalises
demelolemosb : reimbursing
thaon3 : reindeers
laffertyn : rejuggles
fitcha2 : rejuvenized
potterm : relationships
pattisona : relentlessness
tae : releve
bynumg : relieved
hlavacekz : reliever
lazog : relive
wangy4 : rellenos
andersonm2 : relock
tbarkmei : reman
clipperd : remanning
nguyend2 : remarriage
kgalotti : remens
furlongj : remobilises
camerona2 : renatured
schultzm : renitencies
gillenf : renograms
villarrealv : rentable
ehrlichmanc : renunciates
gonzalezs : reoccupying
macdonells : repairmen
rizzoj : repasting
ledskyi : repasture
knightena : replicases
aguilarj : reprehensive
avahi : reprobatively
pharoz : repryved
schudah : repudiations
trann : reseaux
gladishd : resecured
lesneskia : resided
czimmerm : resisters
hew : resolubilities
chens4 : resolutes
hoanga : respades
takamorim : respeaking
winj : respirometric
poulseni : respondence
duncanm2 : restacking
hikinok : resters
wangw4 : retailed
chekhovoiv : retempered
forsythm : reticently
portisj : retiringly
choom : retranslations
zhaos3 : retro
hinzmanna : retrophilias
robinsonj2 : retrorocket
georgep : retrorocket
castanedaj : reusable
mangenat : revalued
hansonk2 : revealable
rogerse2 : revegetations
appelj : revengeful
lunae : reverential
fordn : reversional
vandele : revibrate
muschlerl : revisory
engelk2 : rhapsodising
gilberts2 : rheumatology
mohanm : rhomboids
mitalskim : rhubarbed
wangn4 : rhyne
alstonj : rickets
korpim : rifles
ramosa2 : rigg
apoppick : ripened
moralesk : ritualistic
romans2 : ritzy
shumwaya : riva
yambingj : riverheads
kortaneke : riverway
drivere : roadsman
albrightk : roentgenologic
santosr : rolfing
bridgemana : rollerbladers
schillingm : romancer
fletcherw : ront
boerow : roominess
galambosa : rosining
bigirimanaa : rotavirus
tilsonk : rotter
armstrongk : roughleg
rpetrick : rousement
nicholasp : rousts
brownz2 : rowdedows
mehtaa : rowdier
bengtsone : ruching
peerzadac : ruddles
nortona2 : rufescent
feldbergm : ruffins
tany2 : ruggedizes
xug : rumping
rheeb : rundales
dstephans : ruthlessnesses
bovornvirakitc : sabbatised
daii : sabeing
babbitk : sabellas
willickd : sackings
zerrs : sacrilege
spaine2 : sahib
ellisn : saicks
smeerts : saintisms
simonsi : salaciously
seefeldta : salient
bauern : salivator
lionf : salol
wangk2 : saltest
hollowaya2 : saltoing
heynesk : salvifically
lehmane : salvo
richarte : sambal
zhour : samitis
chowdhuryt : sanga
shiny : sanguines
bakerstahll : santo
stierh : santon
yugovl : sapsago
klinknert : sarnie
wilsong2 : satcheled
cantrelll : satisfiers
tanm3 : satrap
mandalas : saucepot
binzaka : sauries
choie2 : saviors
wangk3 : scagliolas
guv : scants
bells2 : scarph
bettnerj : scazontics
neimana : schnauzer
julies : scintillating
nabaris : scintillons
carragherj : sclerae
tullioo : scolecites
bellovind : scorchings
carlsone3 : scowrer
kuritar : scramblingly
newshams : screeders
izabayop : scribble
fischere2 : scrimpy
change : scriptural
knutsonl2 : scripturally
matha : scrounger
raiyanir : scrump
aldaghlasn : scrutineers
bosshadit : scull
mcadamsg : sculpt
haasl : sculs
solimanh : scumming
duplessisk : scurs
moorej2 : scutter
slopez : scuzzier
gallina2 : sdeining
chammamh : seaning
tranm2 : seawife
millerr2 : secpar
ogradyf : secretory
hussaink : sectorials
mayad : secularity
cooneym2 : securitans
ealexander : seedlips
lewisr2 : seiche
brachoa : seined
rgoerwit : seismonasties
chisholma : sekts
blarocqu : selvaging
abdallan : sememic
eisend : semibreves
friesenb : semierect
zhangc4 : semihoboes
causeyj : seminomata
quinns : seminudities
jacksonk3 : semipalmation
reyesrojasc : semiterete
peeblesa : senses
mensahj : sensile
bareos : sensitivity
yangy2 : sententia
blumenthala : sepads
murphym2 : sepaline
lewisd3 : separatrix
klaitsa : septennate
powello : sequel
zhaoh2 : sequencer
wormanm : sera
lieberkotzo : seriphs
sheffieldf : serotine
jonesj2 : serradella
mosborga : sextillionth
cherkashinaa : sforzandos
shoree : shabbier
ruasanchezf : shaftings
akyianun : shahdom
singerg : shalwars
moranj2 : sharkskin
zewdum : shebang
champlisst : sheerlegs
wilmots2 : shending
escosteguyl : shiels
guangc2 : shikari
floresc2 : shlub
erichc : shmoes
scotti2 : shmoes
brownj4 : shoaling
enriquezd : shoder
shayam : shooras
worrellm : shortheads
mirzaw : shortly
inkelase : shouter
petersonk : shown
friesenh : shrimpiest
troopw : shriveling
willmorej : shriven
fultone : shroomers
etelsonl : shrowd
bremerw : sialids
buik : sib
liud4 : sideswipe
dln : sidings
ekanayakej : siffleur
digavallik : sightsaw
vazquezm : silenus
adalal : silicium
kisselr : silicula
vargol : sillinesses
vithoontienl : simoniac
subramanianr : simpler
aroraj : simplification
lautenbachw : simurg
mccreal : sincereness
laffayet : sinciput
maxwellc2 : sinewiness
berlagej : singlings
pellizzerm : singsongy
witneyj : sinopias
jablem : sinuslike
ziemsr : siri
dalmeidad : siwashes
gueyec : skeg
seths : skepsis
mdecker : skerricks
jgoldfea : sketchiness
mcferrink : skikjoring
bergenee : skillcentres
davish : skimboarder
votawh : skirl
icklera : skirmish
saksoni : skyclad
ssippy : slags
rthompson : slavers
pattersont : sleekers
colcold : sleeve
borlaka : sleevers
lowej2 : slipsheeting
cartyc : sliver
zhangy4 : slivovices
rossa2 : slivowitzes
thomastotha : sloops
mtie : slumbered
dalessioq : smalti
zengt : smartening
mcclaina : smashing
flanaganr : smokejacks
hussains : smouching
dfoxgrov : smouldering
levineb : smuttier
ellisa3 : sneakinesses
cabaacevedof : sneakishly
chackerians : sneeringly
cuid : sneery
kleini : snipelike
lynchy : socdolager
aladetana : sociopaths
bonnellz : socketed
lindholmj : sods
leonettia : sogdolager
vinyarda : solans
lewisz : soliloquised
bommaritom : soliped
tydingsc : solos
chene3 : somaesthetic
systemd-resolve : somewhen
yanaij : sophomoric
velascom : sorry
votrubam : soundcards
shoveb : southeasterly
roethlera : sovietize
jscannell : spamming
goodmans2 : sparse
sollj2 : sparsedly
kimleed : spawnings
kimj5 : spay
dgupta : specializes
weinerk : spectra
youngr2 : speedos
monahans : spidery
carranzas : spiffinesses
moseleys : spininess
clevelandj : spink
khouwa : spirlings
kyhlm : spleenfully
leb : splenius
xiongx2 : splinters
chenk4 : splintwood
caballeron : spoofings
rahadiana : spreadsheet
presserc : spumous
hultgrenk : spurrer
schurs : squabbed
meierj : squabbles
gulledges : squiffy
hayesrichn : squiralties
tnega : squirarchies
raderd : staffman
carlsenm : stairstep
claussa : stargaze
zackss : starred
nagaokay : starwort
younga3 : stationariness
vermam : steamtight
fcontreras : stegodons
stockwella : stellated
mourningl : stemmas
linderd2 : stents
geistk : stewpan
paulsonl : stigmasterol
zhangj4 : stigmatized
antrims : stiltednesses
mohamedn : stockinesses
wolfet : stocktakes
ortiza2 : stoicheiometry
jonese4 : stokehold
smithc6 : stolen
teferar : stomodaeums
wasende : stoner
davidm2 : storiologies
qium : storyboards
nybladel : stotins
qiangt : stoutened
marshn2 : strabometer
cohenn2 : strapontin
vanderwerkerm : strategizing
hallk2 : strives
usbmux : strobilated
sixs2 : strongbox
kotlera : strumpet
yangm4 : strutter
muleyy : stubbornly
deitzman : studworks
leegilligana : stumm
mooren2 : stutterings
stephensm : subarrhations
shiferawh : subeconomic
francos : subgenus
whitedavisj : subitized
chownt : submolecules
johnsonj5 : subphases
grossmank : subraces
meekerd : subscribe
ybenami : subsidisable
mcguckenk : substructure
rayl2 : substyle
trant2 : subtilizer
hafnerb : subvertical
kandelj2 : succourers
fairchildm : succumbed
lefkowitze : suers
redmonds2 : suffices
meyere2 : suffumigated
hodges2 : suites
wirthm : sulphadiazines
parkers2 : sulphurs
wilsonk2 : sultanesses
lus2 : sumptuosity
zhangj8 : sums
mauricen : sunbathings
bozicevicha : sunscalds
shererj : supercolossal
zucka : supererogators
offmane : superexpensive
rawlesa : superheroes
yanr : superhets
lia3 : supermicro
pinkneyn : superrefine
kernallelyc : superterranean
wangw3 : superwife
dkohen : suppletory
zappam : supportively
rosenbergs : supracostal
misraa : supremities
honga : surfactants
bernb : surgical
heywoodl : surmount
kulstadz : surrenderers
assalip : surtitle
luk2 : surveillants
freelandt : swainishnesses
rosss2 : swang
dowlinge2 : sweatiness
wojtowiczi : swelting
wilsona5 : swerfs
speakesd : swigs
babineta : swops
silvaj2 : swordplayers
trank2 : swoun
airoldie : sylis
lynchm2 : syllabized
belln : symbiotic
commonsj : symbolisation
cramptonc : symposium
weldont2 : symptomatic
chavezk : synalepha
yklein : synarchies
wardh2 : syncretism
zhange : synonymatic
garcial2 : synopsising
figueroav : synthesizes
laschc : syringeal
bduffy : systaltic
campanac : tabbinets
priestm2 : tabrets
carlsont3 : tackies
goenkam : taffetases
solakhavam : takingnesses
dudarovw : tallied
quigleyt : talmudisms
leona2 : taluka
hicksr : tamises
trawt : tamponades
hes2 : tannates
ederingtons : tanrec
isaacmans : tantalizers
rosenbergm : tantalous
leuchtenbergerg : tapaculos
sinnerp : tappa
vanormani : tapsalteerie
brattonb : tardies
knospew2 : tartar
kleina4 : tastinesses
whitel3 : tatting
bboling : tays
dejarlaisd : tead
gardnerc2 : teaseled
mooreb : teaselers
ralaimo : teasers
merchantj : technophobics
beemanweberm : technos
kisickic : teils
marksb2 : telecameras
deanj2 : telescreen
srivichainunn : telesoftware
ehrlichc : tenancies
pandeyk : tenderize
guilloryt : tendons
choa : tendrilled
rousseauh : tenebrae
chetitac : tensiometry
wuk2 : terebrating
garnera2 : terrellas
marshs2 : tertiary
kaegig : tester
vcoleman : textphone
nwikeb : thawing
steinkes : theatromania
walkerj2 : thematisations
whitisa : theologizers
hudsonb : therbligs
chuens : thereinafter
reichp : theriomorphosis
shusterl : thermidors
babajidec : thermosiphons
duh2 : thieved
piusa : thimblerigging
lyuk : thinginess
saldiviaf : thirteens
wangh3 : thrae
tartagliaa : throppling
yazdanpanahp : thuggisms
lobetg : thulite
yankwittr : tiddly
moralese : tide
gormane2 : tigs
gunadim : tilefish
jeffersonk : timeservers
tisdalej : tinderboxes
snidmanl : tinklings
moralesc2 : tinnie
mohamedi2 : tipcat
zunigao : tipsier
leonegettens : tironic
limz : title
cooka2 : titulus
singletonj : toc
schallyn : toddies
pompern : toecap
wongrattanapibos : tombs
roesslera : tomcat
shiy : tonging
shuffeltonj : toolholder
starkb : toothless
espinozad : topmast
bunajindaa : toponymies
taftw : topos
wangd5 : toquets
ksmith : tors
oguhc : torsibilities
ngaik : totalizers
otsukae : toughen
frankla : toweling
mustilloe : toxiphagous
leitza : tracheates
rabagoa : tractile
ntomonar : traditionality
bradjanv : tragelaphine
uedah2 : trainee
brownc2 : tramper
pohlmanr : trampolinings
www-data : tranquilizingly
judget : transportings
miyazaway : transposition
binsc : transumes
lauere : travestied
hernandezo : trendier
lians : trephine
bensone : trialists
fleishhackerj : tricar
wilsond3 : trichogynic
finstuenk : tridents
caia : tridominia
siyakurimam : triphone
acerom : triumvir
sirothphiphats : trochosphere
corletta : trod
sloom : trodden
xiangx : trominoes
culottaj : trone
kellerb2 : trophallaxes
lius3 : trotlines
knowlesr : trouncer
halle2 : trudger
barnettb : tsaritza
pottero : tschernosems
andersons : tuboplasties
lindgrena : tubulously
moriyamaa : tuggingly
kraabels : tumultuate
kstclair : tunics
tionga : turbeths
skennedy : turbulencies
joness3 : turcopoles
gullicksonp : turmeric
morelandb : turnkeys
jonesc2 : turnover
dengy : turophiles
zimmermane : turpentined
byrnel : turpentiny
craigj2 : twaddler
diiannic : tweets
stametsf : twiningly
holmesc2 : twinters
_apt : twixt
thompsond : twosomes
brewsterw : tympanics
odubayoj : typecasting
banksa : typhlitises
emlent : typologic
jonesa2 : ultrastructure
bravop : ultroneous
francoj : um
delgadoe : umbracula
ketemah : unadapted
poreddyn : unaddressed
schondorfa : unadvisableness
forsterb : unannoyed
patels4 : unbeginning
smithc4 : unbuckled
wardp : uncanninesses
dannal : uncases
alsheikha : unceasingness
orjalae : uncharnelling
adamsc3 : unclutched
emlene : unconfederated
lamn : unconstrainable
leonarda : uncooperative
systemd-network : uncourteous
mortenseni : uncrosses
baern : undecks
muhlheimr : undedicated
dinardoz : undercool
griffina2 : underfeeding
bosmann : underleasing
prevesc : underlinen
knudsonm2 : undermen
nguyenq3 : undermentioned
cohenl2 : underplots
fbhuiyan : underprising
korobovaj : underproduction
flaksbergc : undershirts
bellc2 : underslung
emckinse : undersupply
gvrtis : undertake
wellera : undertakers
brewsterb : undertane
allgoodm : undertrump
lees6 : undiscussed
paradac : undiverting
meesenat : undrained
hansene2 : uneasier
hughesa2 : unfact
mccaffreyl : unfamiliarly
millikene : unfool
braulickj : unfrequently
peralesa : ungilds
gulatia : ungirt
nika : ungotten
zerwasb : unhairer
rotix : unimprisoned
bartelj : unirradiated
rughanik : uniseptate
aroras2 : unitises
konga : unlikeable
lengyels : unlining
lyang3 : unloveable
chamberlainb : unlovingly
ramans : unnail
yuez : unnaturalise
byunj : unoxidized
sebestab : unpennied
littone : unperceptive
mcohen : unpersuaded
obora : unpin
jehngm : unpretendingly
boyere : unprizable
bullockm : unrecounted
chundrus : unremovable
boitnottj : unrepulsable
baoa : unrooting
zivsaka : unserviceable
bagerekap : unshackled
zhongj2 : unsheltered
bhogarajus : unsnarl
marasht : unsoured
jacobsona : unspared
ohaship : unsparing
lin : untenably
cavanc : untranslatable
laliberteb : untruthfully
stoutlandi : unvarying
mua : unwieldliness
grayt2 : unwifelier
eliasj : unwishful
guangc : upfilled
liuc4 : upload
kucicha : uproaring
cadaramc : upsizing
horia : ur
cturnageb : uredinium
mukherjia2 : urinalyses
suy : urinose
johnsonz2 : urnal
liuq : usurpations
lattaln : utilidors
neidharte : uveitises
pearsonh : vaginulae
williamsa2 : valpolicella
liuf : valuationally
hovingg : vandalising
radinskyj : vaporosities
lic4 : variegators
maticanr : varletries
xiel : vaticinate
arevaloi : vaticinations
mcphersonn : vavasory
boettigerl : vaws
addaberkanem : vealier
obonon : veilleuse
cardonao : veinule
collinsn : venom
eichelt : ventouse
riverab : veratrine
dianas : verberate
patinoj : verifiabilities
lecuyerj : verslibrists
zhenga3 : verstes
winstonl2 : vertiginousness
villanuevaj : vertu
sangvongp : vetchier
parkj3 : vias
buddie : vicaries
fischere3 : vindemiates
dirkswagers : virginium
youngg2 : vitrics
aroras : vocalise
kellerm2 : vociferated
bornsteinm : voidable
pilled : volet
jasmerj : volitational
kaushikkarn : volumetrical
whytem : vomeronasal
haugk2 : voodooistic
bakerc2 : vorago
furtadob : voulge
veraleyvas : vowelizations
yushkoa : waggonettes
yange2 : waide
odiernog : wainscotings
heymane : wais
wangm2 : wait
zhangx2 : wakener
naw : walkways
shiffmanm : wallah
lorenzf : wanted
delgados : wany
thompsond3 : warehousers
amlande : warrey
surdutovicho : washaterias
keaneg : washroom
olsoni : wastrie
nullg : watchet
kotulae : watchets
grovea : waysides
ghaneabassirik : wealsman
bhanijkasemv : weaseller
dallugej : weazens
beebya : webbed
ibtesumm : webster
swaffordx : weepily
harrisona : welking
kunzmank : whaikoreros
conev : whelped
wrighte3 : whemmles
bergert : wherenesses
welchp : wherrits
ricee2 : whetting
zhaob : whicker
braunj : whiffletree
liw : whillywhaws
dillmann : whimsily
birkk : widowman
choyc2 : wincing
lakeh : windroses
liut3 : winier
sweeneyk2 : winns
hussemans : winter
nowakk : wireworkings
smithd3 : wise
poeschlaa : withholding
chai : wolfskins
cheblis : wolver
sudderthm : wonderkid
kimd : woodbine
flemingw2 : woodenheads
piperh : wooding
williamsonw : woodpigeon
franzene : woozinesses
casperd2 : wordbreak
zhaidar : workhours
ansara : workingman
uttleyg : worldlinesses
josephn : worst
saned : wrappering
kims2 : wrast
lamj : wrinkling
mcveighq : wristbands
xiaol : wristbands
collinsm2 : wry
laceyi : wus
newellr : wuzzling
williamsj5 : wynds
boyuml : xenolith
isaacsj3 : xerophily
quanbecks : xiphoid
blocka : xiphosuran
yazdim : xylobalsamum
casmeym : yachter
kimb2 : yahoos
dakaw : yappies
rosenfieldn : yarmulka
barfieldt : yaw
weinsteinc : ycled
blaneym : yeading
yangz2 : yellowcakes
reecel : yestermorn
freedmanm : yities
jimenezf : yob
webbl2 : yonnie
nawm : youthful
jinj : yuan
mukherjia : zarapes
chenga3 : zastruga
alsheikhc : zestless
morrisn : zhomos
williamsc : zizel
pedersena : zoarium
yel : zoographical
hirshbergs : zootechnies
kellyp2 : zootrophies
harrisn2 : zwitterionic
sajwanis : zygocactus
haddady : zymology
